1111111111111
10010000P0001
10000111110C1
1000110000E01
1111111111111