1111111111111
1C010000000C1
1100011110011
1P0011E100001
1111111111111