1111111111111
10010000P0001
10000111110C1
100011E000001
1111111111111