111111111111111111111111111111111111111111
10001000C0000000000C1C0010000010000C1C0001
10C000001000001100000000010100100000100001
1000110010000011100000011000000010001001E1
10P000011000000100000000100101000010000011
100011001100100000000110000110000110000011
100010000001100100C0000010C001100010010011
1000000110011C0000000000001000000110000111
110011110011000100111000011001101100100011
1000001000010010000010000011000000000C0001
110010011000000010000110010001110001000011
100010000100110000000111000011001001100001
100001001000010010010001100111100001110011
11000000C0000001100C0011110000011001000011
1001000001110000011000000001001110100C0001
1000011000011000010010C0011001000011000001
100001100010001000000110000100000000010001
1C0000001000011000110001101000000110000001
110010000011001100010000000010000001100011
110000011001001100001100000110100000001001
100010000100000110001001100000001001100011
10C001000C000100000C1100011101000011C00001
111111111111111111111111111111111111111111