1111111111111111111
1000010000C00000001
1C00E00P00C00011101
1C00000000C00000111
1C00011000C00000001
1C00111100C00C01001
1C00011000C00C01001
1C00000100C00C01001
1C00010000C00C01001
1C00100000C00C01001
1111111111111111111