1111111111111111111
1000011100C00000001
1C00E11100C01111101
1C00000000C00000111
1C00011000C01110001
1110111111101101001
1C00011000C00C01001
1C00000100C01101001
1C00011110C11C01001
1C00111000C00C01001
1111111111111111111