11111111111111111111111111111111
1100000000C0111110C1111100111111
110010C1110000110000011111100E11
11000001111100000111111111110111
100011000000P1110000000000110111
11100101110110100111001100110011
10000001110111110111110000001011
101011010C000000011111110100C011
10001100000000110001100000111111
10101101000000101011111011111111
10001011011010101000000000000C11
10101110111010111001010C00000111
1C0010010C1110001001C10000000011
110C00000000C0101000000000011111
11111111111111111111111111111111