11111111111111111111111111111111
1100000000C0111110C1111100111111
111110C1110000110000011111100E11
11111111111100000111111111110111
111111000000P1110000000000110111
11111101110110100111001100110011
10000001110111110111111100001011
101011010C111110011111110100C011
10101100001111110001111101111111
10101101111111110101111101111111
10101011011010101000011100000C11
10101110111110111111011C00000111
1C1011110C1110101111C11111111111
111C00000000C1101001111111111111
11111111111111111111111111111111