1111111111111


1010000000C11


1010X11111001


1P0011E000001


1111111111=11